
SO img/naruto.png

F 255,197,0
C 70,0,255

F 70,0,255

NO img/akame.png
SO img/power.png
WE img/karma.png
EA img/naruto.png

NO img/power.png
WE img/power.png
EA img/power.png

111111111111111111
1S00000000000001001           1
100000000000000001           101
100000000000000111            1
1000000000000001         
1000000000000001
1111111111111111

c kua seu parecingue scihobbanne ?