F 255,255,0
C 0,255,255

NO img/kirby.png
SO img/mario.png
WE img/pacman.png
EA img/sonic.png

   1111111111111111111111111111111111111111111111111111111111111111111111111111111111
111001
10001
10N01111111111111111111111
10000000000000000000000001
11111111111111111111111111
