F 139,99,58
C 171,154,137

NO img/cub1.png
SO img/cub2.png
WE img/cub3.png
EA img/cub4.png

1111111111111111111
1001001001001001001
1001001001001001001
1001001001001001001
1001001000001001001
100000000S000000001
1000011111111000001
1111000000000001111
1000000101010000001
1111111111111111111

