






NO img/cub1.png








SO img/cub2.png
   WE                     img/cub3.png
        EA img/cub4.png

        F 20,           20,             20
C 200,          200,200

11111
10001
10S01
10001
10001
10001
11001
10001
10001
10001
10001
10001
11111























