NO img/cub1.png
SO img/cub2.png
WE img/cub3.png
EA img/cub4.png

F 18,53,25
C 153,204,255

111111111111
1         11
1       0001
1000000 0011
10S000000001
111111111111
11         1
111111111111
