   WE                            img/cub3.png
NO      img/cub1.png



SO img/cub2.png

F      17,    38,     64

EA img/cub4.png



C 218, 234, 235

111111
100001
100001
100001
100001    1
100001   1S1
111111    1
1
1
                   
1
1111
1001
1111
