NO img/akame.png
SO img/power.png
WE img/karma.png
EA img/naruto.png

F 20,20,20
C 200,200,200

11111
00000
00000
00S00
00000
00000
11111
