F 		2, 		197		,10
C 70,0,255

NO img/akame.png
SO img/power.png
WE img/karma.png
EA img/naruto.png

11111111111111111111111111111111111111111111111111111
10000000000000000000000000000000000000000000000000001
10000000000000000000000000000000000000000000000000001
10S00000000000000000000000000000000000000000000000011  1
10000000000000000000000000000000000000000000000000001
10000000000000000000000000000000000000000000000000001
10000000000000000000000000000000000000000000000000001
10000000000000000000001111111000000000000000000000001
10000000000000000000000001000000000000000000000000001
10000000000000000000000001000000000000000000000000001
10000000000000000000000001000000000000000000000000001
10000000000000000000000000000000000000000000000000001
10000000000000000000000000000000000000000000000000001
10000000000000000000000000000000000000000000000000001
10000000000000000000000000000000000000000000000000001111
10000000000000000000000000000000000000000000000000001
10000000000000000000000000000000000000000000000000001
10000000000000000000000000000000000000000000000000001
10000000011111111000000000000000000001111111100000001
10000000011111111000000000000000000001111111100000001
10000000011111111000000000000000000001111111100000001
11111111111111111111111111111111111111111111111111111
1
1
1
1
1111
1111
1111
