F 255,197,0
C 70,0,255

NO img/akame.png
SO img/power.png
WE img/karma.png
EA img/naruto.png

11111111111111111111111111111111111111111111111111111
10000000000000000000000000000000000000000000000000001
10000000000000000000000000000000000000000000000000001
10000000000000000000000000000000000000000000000000001
10000000000000000000000000000000000000000000000000001
10000000000000000000000000000000000000000000000000001
10000000000000000000000000000000000000000000000000001
10000000000000000000001111111000000000000000000000001
10000000000000000000000001000000000000000000000000001
10000000000000000000000001000000000000000000000000001
10000000000000000000000001000000000000000000000000001
10000000000000000000000000000000000000000000000000001
10000000000000000000000000000000000000000000000000001
10000000000000000000000000000000000000000000000000001
10000000000000000000000000000000000000000000000000001
10000000000000000000000000000000000000000000000000001
10000000000000000000000000000000000000000000000000001
10000000000000000000000000000000000000000000000000001
10000000011111111000000000000000000001111111100000001
10000000011111111000000000000000000001111111100000001
10000000011111111000000000000000000001111111100000001
10000000011111111000000000000000000001111111100000001
10000000011111111000000000000000000001111111100000001
10000000000000000000000000000000000000000000000000001
10000000000000000000000000000000000000000000000000001
10000000000000000000000000000000000000000000000000001
10000000000000000000000000000000000000000000000000001
10000000000000000000000000000000000000000000000000001
10000000000000000000000000000000000000000000000000001
10000000000000000000000000000000000000000000000000001
10000000000000000000000000000000000000000000000000001
10000000011111111000000000000000000001111111100000001
10000000011111111000000000000000000001111111100000001
10000000011111111000000000000000000001111111100000001
10000000011111111000000000000000000001111111100000001
10000000011111111000000000000000000001111111100000001
10000000011111111000000000000000000001111111100000001
10000000000000000000000000000000000000000000000000001
10000000000000000000000000000000000000000000000000001
10000000000000000000000000000000000000000000000000001
10000000000000000000000000000000000000000000000000001
10000000000000000000000000000000000000000000000000001
10000000000000000000000000000000000000000000000000001
10000000000000000000000000000000000000000000000000001
10000000000000000000000000000000000000000000000000001
10000000011111111000000000000000000001111111100000001
10000000011111111000000000000000000001111111100000001
10000000011111111000000000000000000001111111100000001
10000000011111111000000000000000000001111111100000001
10000000011111111000000000000000000001111111100000001
10000000011111111000000000000000000001111111100000001
10000000000000000000000000000000000000000000000000001
10000000000000000000000000000000000000000000000000001
10000000000000000000000000000000000000000000000000001
10000000000000000000000000000000000000000000000000001
10000000000000000000000000000000000000000000000000001
100000000000000000000000000000000000000000000000000W1
11111111111111111111111111111111111111111111111111111
