F 128,128,128
C 255,255,255

NO img/cub1.png
SO img/cub2.png
WE img/cub3.png
EA img/cub4.png

11111111111111111111111111111111111111111111111111111
10000000000000000000000000000000000000000000000000001
10010000000000100000000000000000000000001000000000001
10000000000000000000000000000100000000000000000000001
10000000000001000000100000100001000010010011000000001
10000000000000000000000000000000000000000011000000001
10000000000000000000000000000000000000000000000000001
10000000000001000000001111111000000000000000000000001
10000000000000000000001111111000000000001000000000001
10000000001000000000001111111000000000000000000000001
10000000000000000000001111111000000000000000000000001
10000001000000000000000000000000000000000000000000001
10000000000000001000000000000000100000000000100000001
10000000000000000000000000000000000000000000000000001
10000000010000000000001000000000000001000000000000001
10000000000000001000000000000000000000000000000000001
10000000000000000000000000000000000000000001000000001
10000000000000000000000000000000000000000000000000001
10010000011111111000000000001000000001111111100100001
10000000011111111000001000000000000001111111100000001
10000000011111111000000000000000000001111111100000001
10000100011111111000000000001000000001111111100010001
10000000011111111000001000000000000001111111100000001
10000000000000000000000000000000000000000000000000001
10000000000000100000000000001000000000000000000000001
10000000000000000000001000000000000000000000100000001
10000000010000000000000000000000000000000000000000001
10000000000000000000000000001000000000000000000000001
10000010000000000000001000000000000000010000000000001
10000000000000010000000000000000000000000000000000001
10000000000000000000000000000000000000000000000000001
10000000011111111000001000001000000001111111100000001
10000000011111111000000000000000000001111111100000001
10000000011111111000000000000000000001111111100000001
10000000011111111000001000000000000001111111100000001
10000000011111111000000000001000000001111111100000001
10000000011111111000000000000000000001111111100000001
10000000000000000000001000000000000000000000000000001
10000000000000000000000000000000000000000000000000001
10000000100000000000000000001000000000000001000000001
10000000000000000000000000000000000010000000000000001
10000000001000000000000100000000000000000000000000001
10000000000000000000000000000000000000001000000000001
10000000000000000100000000000000000000000000000000001
10000000000000000000000000000000000000000000000000001
10000000011111111000000000000000100001111111100000001
10000000011111111000000000000000000001111111100000001
10000000011111111000000000000000000001111111100000001
10000000011111111000000100000000000001111111100000001
10000000011111111000000000000000000001111111100000001
10000000011111111000000000000000000001111111100000001
10000000000000000000000000000000000000000000000000001
10000000000000000000000000010000000000000000000000001
10000000000000000000000000000000000100000000000000001
10000000000010000000000000000000000000000000000000001
10000000000000000001000000000000000000000000000000001
100000000000000000000000000000000000000000000000000W1
11111111111111111111111111111111111111111111111111111
