F 255,255,255
C 30,0,0

NO img/nord.png
SO img/sud.png
WE img/est.png
EA img/ouest.png

111111111111111111111111111111111111111111
100000000000000000000000000000000000000001
100000000000000000000000000000000000000001
10000000000000000000N000000000000000000001
100000000000000000000000000000000000000001
100000000000000000000000000000000000000001
100000000000000000000000000000000000000001
100000000000000000000000000000000000000001
100000000000000000000000000000000000000001
100000000000000000000000000000000000000001
100000000000000000000000000000000000000001
100000000000000000000000000000000000000001
100000000000000000000000000000000000000001
100000000000000000000000000000000000000001
100000000000000000000000000000000000000001
100000000000000000000000000000000000000001
100000000000000000000000000000000000000001
100000000000000000000000000000000000000001
100000000000000000000000000000000000000001
100000000000000000000000000000000000000001
100000000000000000000000000000000000000001
100000000000000000000000000000000000000001
100000000000000000000000000000000000000001
100000000000000000000000000000000000000001
100000000000000000000000000000000000000001
100000000000000000000000000000000000000001
100000000000000000000000000000000000000001
100000000000000000000000000000000000000001
10000000000000000000000000000000000000000111111111111111111111111111111111
10000000000000000000000000000000000000000000000000000000000000000000000001
11111111111111110000000000000000000000000000000000000000000000000000000001
               10000000000000000000000000000000000000000000000000000000001
               10000000000000000000000000000000000000000000000000000000001
               10000000000000000000000000000000000000000000000000000000001
               10000000000000000000000000000000000000000000000000000000001
               10000000000000000000000000000000000000000000000000000000001
               10000000000000000000000000000000000000000000000000000000001
               10000000000000000000000000000000000000000000000000000000001
               10000000000000000000000000000000000000000000000000000000001
               10000000000000000000000000111111100000000000000000000000001
               100000000000000000000000001     100000000000000000000000001
               10000000000000000000000000111111100000000000000000000000001
               10000000000000000000000000000000000000000000000000000000001
               10000000000000000000000000000000000000000000000000000000001
               10000000000000000000000000000000000000000000000000000000001
               10000000000000000000000000000000000000000000000000000000001
               10000000000000000000000000000000000000000000000000000000001
               10000000000000000000000000000000000000000000000000000000001
               10000000000000000000000000000000000000000000000000000000001
               10000000000000000000000000000000000000000000000000000000001
               10000000000000000000000000000000000000000000000000000000001
               10000000000000000000000000000000000000000000000000000000001
               10000000000000000000000000000000000000000000000000000000001
               10000000000000000000000000000000000000000000000000000000001
               10000000000000000000000000000000000000000000000000000000001
               10000000000000000000000000000000000000000000000000000000001
               10000000000000000000000000000000000000000000000000000000001
               10000000000000000000000000000000000000000000000000000000001
               10000000000000000000000000000000000000000000000000000000001
               10000000000000000000000000000000000000000000000000000000001
               10000000000000000000000000000000000000000000000000000000001
               10000000000000000000000000000000000000000000000000000000001
               10000000000000000000000000000000000000000000000000000000001
               10000000000000000000000000000000000000000000000000000000001
               10000000000000000000000000000000000000000000000000000000001
               10000000000000000000000000000000000000000000000000000000001
               10000000000000000000000000000000000000000000000000000000001
               10000000000000000000000000000000000000000000000000000000001
               10000000000000000000000000000000000000000000000000000000001
               11111111111111111111111111111111111111111111111111111111111
