NO img/akame.png
SO img/power.png
WE img/karma.png
EA img/naruto.png

F 18,53,25
C 153,204,255

111111111111
1         11
1       0001
1000000 0011
10S000000001
111111111111
