11111111111111111
10000000000000001
10000000000000001
10000011111000001
10000000100000001
10000000100000001
10000000000000001
10000000N00000001
10000000000000001
11111111111111111