F 139,99,58
C 171,154,137

NO test.xpm
SO test.xpm
WE test.xpm
EA test.xpm

11111111111111111 111111111111111111111111111
10000000000000001 100000000000000000000000001
10000000000000001 100000000000000000000000001
100000000000000011100000000000000000000000001
100000000000000011100000000000000000000000001
100000000000000011100000000111111111000000001
1000001111100000111000000001111 1111000000001
100000001000000011100000000000111000000000001
100000001000000011100000000000111000000000001
100000000000000011100000000000111000000000001
10000000S000000000000000000000000000000000001
100000000000000000000000000000000000000000001
100000000000000000000000000000000000000000001
100000000000000000000000000000000000000000001
100000000000000000000000000000000000000000001
100000000000000000000000000000000000000000001
100000000000000000000000000000000000000000001
100000000000000000000000000000000000000000001
111111111111111111111111001111111111111111111
                       1001   
                       1001
                       1001
111111111111111111111111001111111111111111111
100000000000000000000000000000000000000000001
100000000000000000000000000000000000000000001
100000000000000000000000000000000000000000001
111111111111111111111111111111111111111111111