111111111111111111111111111
100000000000000000000000001
100000000000000000000000001
100000000001111100000000001
100000000000010000000000001
100000000000010000000000001
100000000000000000000000001
1000000000000S0000000000001
100000000000000000000000001
100000000000000000000000001
100000000111111110000000001
100000000111111110000000001
100000000111111110000000001
100000000000000000000000001
100000000000000000000000001
111111111111111111111111111