11111111111111111111111111111111111111111111111111111
10000000000000000000000000000000000000000000000000001
10000000000000000000000000000000000000000000000000001
10000000000000000000000000000000000000000000000000001
10000000000000000000000000000000000000000000000000001
10000000000000000000000000000000000000000000000000001
10000000000000000000000000000000000000000000000000001
10000000000000000000001111111000000000000000000000001
10000000000000000000000001000000000000000000000000001
10000000000000000000000001000000000000000000000000001
10000000000000000000000001000000000000000000000000001
1000000000000S000000000000000000000000000000000000001
10000000000000000000000000000000000000000000000000001
10000000000000000000000000000000000000000000000000001
10000000000000000000000000000000000000000000000000001
10000000000000000000000000000000000000000000000000001
10000000000000000000000000000000000000000000000000001
10000000000000000000000000000000000000000000000000001
10000000011111111000000000000000000001111111100000001
10000000011111111000000000000000000001111111100000001
10000000011111111000000000000000000001111111100000001
10000000011111111000000000000000000001111111100000001
10000000011111111000000000000000000001111111100000001
10000000000000000000000000000000000000000000000000001
10000000000000000000000000000000000000000000000000001
10000000000000000000000000000000000000000000000000001
10000000000000000000000000000000000000000000000000001
10000000000000000000000000000000000000000000000000001
10000000000000000000000000000000000000000000000000001
10000000000000000000000000000000000000000000000000001
10000000000000000000000000000000000000000000000000001
10000000011111111000000000000000000001111111100000001
10000000011111111000000000000000000001111111100000001
10000000011111111000000000000000000001111111100000001
10000000011111111000000000000000000001111111100000001
10000000011111111000000000000000000001111111100000001
10000000011111111000000000000000000001111111100000001
10000000000000000000000000000000000000000000000000001
10000000000000000000000000000000000000000000000000001
10000000000000000000000000000000000000000000000000001
10000000000000000000000000000000000000000000000000001
10000000000000000000000000000000000000000000000000001
10000000000000000000000000000000000000000000000000001
10000000000000000000000000000000000000000000000000001
10000000000000000000000000000000000000000000000000001
10000000011111111000000000000000000001111111100000001
10000000011111111000000000000000000001111111100000001
10000000011111111000000000000000000001111111100000001
10000000011111111000000000000000000001111111100000001
10000000011111111000000000000000000001111111100000001
10000000011111111000000000000000000001111111100000001
10000000000000000000000000000000000000000000000000001
10000000000000000000000000000000000000000000000000001
10000000000000000000000000000000000000000000000000001
10000000000000000000000000000000000000000000000000001
10000000000000000000000000000000000000000000000000001
10000000000000000000000000000000000000000000000000001
11111111111111111111111111111111111111111111111111111