11111111111111111111111
10000000000000000000001
10000000000000000000001
10000000000000000000001
10000000000000000000001
10000000000000000000001
10000000000000000000001
10000000000000000000001
1000000000000000000000111111111111111111
1111111111111111000000000000000000000001
               1000000000000000000000001
               1000000000000000000000001
               1E00000000000000000000001
               1000000000000000000000001
               1000000000000000000000001
               1000000000000000000000001
               1000000000000000000000001
               1000000000000000000000001
               1111111111111111111111111