111111111111111111111111111111111111111111
1S0000000000000000000000000000000000000001
100000000000000000000000000000000000000001
100000000000000000000000000000000000000001
100000000000000000000000000000000000000001
100000000000000000000000000000000000000001
100000000000000000000000000000000000000001
100000000000000000000000000000000000000001
100000000000000000000000000000000000000001
100000000000000000000000000000000000000001
100000000000000000000000000000000000000001
100000000000000000000000000000000000000001
100000000000000000000000000000000000000001
100000000000000000000000000000000000000001
100000000000000000000000000000000000000001
100000000000000000000000000000000000000001
100000000000000000000000000000000000000001
100000000000000000000000000000000000000001
100000000000000000000000000000000000000001
100000000000000000000000000000000000000001
100000000000000000000000000000000000000001
100000000000000000000000000000000000000001
100000000000000000000000000000000000000001
100000000000000000000000000000000000000001
100000000000000000000000000000000000000001
100000000000000000000000000000000000000001
100000000000000000000000000000000000000001
100000000000000000000000000000000000000001
10000000000000000000000000000000000000000111111111111111111111111111111111
10000000000000000000000000000000000000000000000000000000000000000000000001
11111111111111110000000000000000000000000000000000000000000000000000000001
               10000000000000000000000000000000000000000000000000000000001
               10000000000000000000000000000000000000000000000000000000001
               10000000000000000000000000000000000000000000000000000000001
               10000000000000000000000000000000000000000000000000000000001
               10000000000000000000000000000000000000000000000000000000001
               10000000000000000000000000000000000000000000000000000000001
               10000000000000000000000000000000000000000000000000000000001
               10000000000000000000000000000000000000000000000000000000001
               10000000000000000000000000000000000000000000000000000000001
               10000000000000000000000000000000000000000000000000000000001
               10000000000000000000000000000000000000000000000000000000001
               10000000000000000000000000000000000000000000000000000000001
               10000000000000000000000000000000000000000000000000000000001
               10000000000000000000000000000000000000000000000000000000001
               10000000000000000000000000000000000000000000000000000000001
               10000000000000000000000000000000000000000000000000000000001
               10000000000000000000000000000000000000000000000000000000001
               10000000000000000000000000000000000000000000000000000000001
               10000000000000000000000000000000000000000000000000000000001
               10000000000000000000000000000000000000000000000000000000001
               10000000000000000000000000000000000000000000000000000000001
               10000000000000000000000000000000000000000000000000000000001
               10000000000000000000000000000000000000000000000000000000001
               10000000000000000000000000000000000000000000000000000000001
               10000000000000000000000000000000000000000000000000000000001
               10000000000000000000000000000000000000000000000000000000001
               10000000000000000000000000000000000000000000000000000000001
               10000000000000000000000000000000000000000000000000000000001
               10000000000000000000000000000000000000000000000000000000001
               10000000000000000000000000000000000000000000000000000000001
               10000000000000000000000000000000000000000000000000000000001
               10000000000000000000000000000000000000000000000000000000001
               10000000000000000000000000000000000000000000000000000000001
               10000000000000000000000000000000000000000000000000000000001
               10000000000000000000000000000000000000000000000000000000001
               10000000000000000000000000000000000000000000000000000000001
               10000000000000000000000000000000000000000000000000000000001
               10000000000000000000000000000000000000000000000000000000001
               11111111111111111111111111111111111111111111111111111111111