F 139,99,58
C 171,154,137

NO img/tex1.png
SO img/tex2.png
WE img/tex3.png
EA img/tex4.png

111111111111111111111111111111111111111111111111111111111
100000000000000111000000000000000000000001100000000000001
10E000000000000111000000000000000000000001100000000000001
100000000000000111000000000000000000000001100000000000001
111111000111000111111111111111111111110001100011111110001
11111100011100000000000000000000000000000110001111111000111111111
10000000011100000000000000000000000000000110001000000000000000001
10000000011100000000000000000000000000000110001000000000000000001
10000000011111111111111100011111111111111110001000000000000000001
100011111111000000000000000111000000000000000010000000000000000011111111
100011111111000000000000000111000000000000000010000000000000000000000001
100011111111111111111111111111000000000000000011111111000000000000000001
100011111111111111111111111111000111111111111111111111000000000000000001
100000000000000011000000000000000000000000000001100011000000000000000001
100000000000000011000000000000000000000000000001100011000000000000000001
100000000000000011000000000000000000000000000001100011000000000000000001
111111111111100011111111111111111111111111110001100011000000000000000001
110000000000000000000000000000000000000000000001100011000000000000000001
110000000000000000000000000000000000000000000001100011000000000000000001
110000000000000000000000000000000000000000000001100011000000000000000001
110001111111111111111111111111111111111111111111100011111111111111110001
110001111111111111111111111111111111111111111111100011111111111111110001
110001100000000000000000000000000000000000000000000000000000000000110001
110001100000000000000000000000000000000000000000000000000000000000110001
110001100000000000000000000000000000000000000000000000000000000000110001
110001100011111111111111111111111111111111111111111111111111111000110001
110001100011111111111111111111111111111111111111111111111111111000110001
110001100011000000000000000000000000000000000000000000000001111000110001
110001100011000000000000000000000000000000000000000000000001111000110001
110001100011000000000000000000000000000000000000000000000001111000110001
110001100011000111111111111111111111111111111111111111111111111000110001
110001100011000110001111111111111111111111111111111111111111111000110001
110001100011000110001100000000110000000011000000000000000000011000110001
110001100011000110001100000000110000000011000000000000000000011000110001
110001100011000110001100000000110000000011000000000000000000011000110001
110001100011000110001100011000110001100011111111111111111100011000110001
110000000000000000000000011000000001100000000000000000000000011000110001
110000000000000000000000011000000001100000000000000000000000011000110001
110000000000000000000000011000000001100000000000000000000000011000110001
111111100011111111111111111111111111111111111111111111111111111000110001
110001100011111111111111111111111111111111111111111111111111111000110001
110001100000000000000000000000000000000000000000000000000000000000110001
110001100000000000000000000000000000000000000000000000000000000000110001
110001100000000000000000000000000000000000000000000000000000000000110001
110001111111000111111111111111111111111111111111111111111111111111110001
110000000000000000000000000000000000000000000000000000000000000000000001
110000000000000000000000000000000000000000000000000000000000000000000001
110000000000000000000000000000000000000000000000000000000000000000000001
111111111111111111111111111111111111111111111111111111111111111111111111