F 128,128,128
C 0,0,0

NO img/spaceship1.png
SO img/spaceship2.png
WE img/spaceship3.png
EA img/spaceship4.png


1111111111111111111111111111111
1000000000000000000000000000001
100000000000000000000000000W001
1000000000000000000000000000001
1000011111111111111111111111111
100011
100001
100001
100001
100011
100001
100001
100001
100011
100001
100001
100001
100011
100001
100001
100001
100011                                                                     111111
100001111111111111111111111111111111111111111111111111111111111111111111111100001
100000000000000000000000000000000000000000000000000000000000000000000000000000001
100001111111111111111111111111111111111111111111111111111111111111111111111100001
100011                                                                     111111
100001
100001
100001
100011                                                                     111111
100001111111111111111111111111111111111111111111111111111111111111111111111100001
100000000000000000000000000000000000000000000000000000000000000000000000000000001
100001111111111111111111111111111111111111111111111111111111111111111111111100001
100011                                                                     111111
100001
100001
100001
100011
100001
100001
100001
100011
100001
100001
100001
100011
100001
100001
100001
100011
100001
100001
100001
100011
100001
100001
100001
100011
100001
100001
100001
100011                                                                     111111
100001111111111111111111111111111111111111111111111111111111111111111111111100001
100000000000000000000000000000000000000000000000000000000000000000000000000000001
100001111111111111111111111111111111111111111111111111111111111111111111111100001
100011                                                                     111111
100001
100001
100001
100011
100001
100001
100001
100011
100001
100001
100001
100011
100001
100001
100001
100011
100001
100001
100001
100011                                                                     111111
100001111111111111111111111111111111111111111111111111111111111111111111111100001
100000000000000000000000000000000000000000000000000000000000000000000000000000001
100001111111111111111111111111111111111111111111111111111111111111111111111100001
100011                                                                     111111
100001
100001
100001
111111
