NO img/cub1.png
SO img/cub2.png
WE img/cub3.png
EA img/cub4.png

        F 20,           20,             20
C 200,          200,200

111
1N1
101
101
101
101
101
101
101
111111























