NO img/cub1.png
SO img/cub2.png
WE img/cub3.png
EA img/cub4.png

        F 20,           20,             20
C 200,          200,200

111
1S1
101
101
1011111111111111111111111111111111111111111111111111111111111111111111111111111111111111111111111111111111111111111111111111111111111111111111111111111111111111111111111111111111111111111111111111111111111111111111111111111111111111111111111111111111111111111
1010000000000000000000000000000000000000000000000000000000000000000000000000000000000001000000001001000000000001000000001000000010100000000000000000000000100000000000000000000000000000000000000000000000001000000000000000000000100000000000000000000000000001111
100000000000000000000000000000000000000000000000000000000000000000000000000000000000000000000001000000001000001000010001000100000100010000000000000000000100000000000000000000000000000000000000000000000001000000000000000000000000000000000100000000000000001111
10111000000000000000000000000000000000000000000000000000000000000000000000000000000000010000000000000100010010000000100010001000100000000000000000000000000000000000000000000000000000000000000000000000000000000000000000000000001000000000001000000000000000001111
11110000000000000000000000000000000000000000000000000000000000000000000000000000000000000000000010010000010000001000100000001000000000100000000000000000001000000000000000000000000000000000000000000000000010000000000000000000001000000000000000000000000000001111
11111111111111111111111111111111111111111111111111111111111111111111111111111111111111111111111111111111111111111111111111111111111111111111111111111111111111111111111111111111111111111111111111111111111111111111111111111111111111111111111111111111111111111111
1001
1111
